001110101111101111
101111101111101111
111110101111101111
111011101111101111
000000101111101111
101111101111101111
